[[9,9,9,9,9,9,9,9,9,9,9,9,9,9,9,9,9,9,9,9]
 [9,1,1,1,1,1,1,1,1,1,1,1,1,1,1,1,1,1,8,9]
 [9,1,1,1,1,1,1,1,1,1,1,1,1,1,1,1,1,1,1,9]
 [9,1,1,1,1,1,1,1,1,1,1,1,1,1,1,1,1,1,1,9]
 [9,1,1,1,1,1,1,1,1,1,1,1,1,1,1,1,1,1,1,9]
 [9,1,1,1,1,1,1,1,1,1,1,1,1,1,1,1,1,1,1,9]
 [9,1,1,1,1,1,1,1,1,1,1,1,1,1,1,1,1,1,1,9]
 [9,1,1,1,1,1,1,1,1,1,1,1,1,1,1,1,1,1,1,9]
 [9,1,1,1,1,1,1,1,1,1,1,1,1,1,1,1,1,1,1,9]
 [9,1,1,1,1,1,1,1,1,1,1,1,1,1,1,1,1,1,1,9]
 [9,1,1,1,1,1,1,1,1,1,1,1,1,1,1,1,1,1,1,9]
 [9,1,1,1,1,1,1,1,1,1,1,1,1,1,1,1,1,1,1,9]
 [9,1,1,1,1,1,1,1,1,1,1,1,1,1,1,1,1,1,1,9]
 [9,1,1,1,1,1,1,1,1,1,1,1,1,1,1,1,1,1,1,9]
 [9,1,1,1,1,1,1,1,1,1,1,1,1,1,1,1,1,1,1,9]
 [9,1,1,1,1,1,1,1,1,1,1,1,1,1,1,1,1,1,1,9]
 [9,1,1,1,1,1,1,1,1,1,1,1,1,1,1,1,1,1,1,9]
 [9,1,1,1,1,1,1,1,1,1,1,1,1,1,1,1,1,1,1,9]
 [9,0,1,1,1,1,1,1,1,1,1,1,1,1,1,1,1,1,1,9]
 [9,9,9,9,9,9,9,9,9,9,9,9,9,9,9,9,9,9,9,9]]